1 0 2 0 1 2 0 4 4 4 4 4 1 2 0 2
0 1 2 0 1 0 2 4 7 7 7 4 0 1 0 1
8 8 8 8 8 8 8 4 7 7 7 4 8 8 8 8
8 8 8 8 8 8 8 4 7 7 7 4 8 8 8 8
0 2 1 0 2 0 1 5 5 0 5 5 1 0 1 1
0 1 2 0 2 1 0 2 1 0 2 0 1 0 2 2
0 2 1 0 1 2 0 2 1 0 2 0 1 0 2 1
1 0 2 0 1 2 0 1 0 2 0 1 0 2 1 0
2 0 0 2 1 0 1 2 0 1 2 0 1 2 0 1
2 1 0 2 1 0 2 0 1 0 2 1 0 2 1 0
0 2 0 2 0 1 2 0 2 1 0 0 1 2 0 1
2 1 0 0 1 2 0 1 0 2 0 2 2 0 2 1
2 2 1 0 1 0 0 1 0 1 0 2 2 0 2 0
2 1 0 2 0 2 1 0 2 1 0 2 1 0 1 2